,"[('gen', 'der'), ('usd', 'der'), ('ent', 'ent')]","[['der', 'der', 'ent']]","[['gen', 'act'], ['der', 'ent'], ['der', 'ent']]","[['gen', 'usd', 'ent']]","[['usd', 'der', 'ent']]","[['usd', 'ent'], ['usd', 'ent']]",act,ent,label
0,10,2,20,4,6,10,10,28,Mystic
1,2,4,10,4,3,5,5,14,Valor
2,2,0,4,2,1,2,2,7,Mystic
3,4,4,12,4,4,6,6,17,Valor
4,2,0,4,2,1,2,2,7,Valor
5,4,0,6,2,2,3,3,10,Mystic
6,0,0,2,2,0,1,1,4,Valor
7,10,6,24,6,8,12,12,33,Instinct
8,8,0,10,2,4,5,5,16,Mystic
9,6,0,8,2,3,4,4,13,Mystic
10,2,0,4,2,1,2,2,7,Valor
11,2,0,4,2,1,2,2,7,Valor
12,0,0,2,2,0,1,1,4,Valor
13,2,0,4,2,1,2,2,7,Valor
14,14,4,24,6,9,12,12,35,Instinct
15,0,0,2,2,0,1,1,4,Valor
16,8,8,26,10,8,13,13,36,Instinct
17,14,6,28,6,10,14,14,39,Instinct
18,20,0,22,2,10,11,11,34,Instinct
19,0,2,6,2,1,3,3,8,Mystic
20,6,4,16,6,5,8,8,23,Instinct
21,4,0,6,2,2,3,3,10,Mystic
22,0,0,2,2,0,1,1,4,Mystic
23,10,4,20,4,7,10,10,28,Instinct
24,12,6,30,6,9,15,15,40,Instinct
25,10,6,24,8,8,12,12,34,Instinct
26,0,0,2,2,0,1,1,4,Mystic
27,0,0,2,2,0,1,1,4,Valor
28,16,2,22,4,9,11,11,33,Instinct
29,12,0,14,2,6,7,7,22,Instinct
30,12,2,18,4,7,9,9,27,Instinct
31,0,2,4,2,1,2,2,6,Valor
32,0,2,4,2,1,2,2,6,Mystic
33,0,0,2,2,0,1,1,4,Mystic
34,10,6,26,8,8,13,13,36,Instinct
35,12,2,18,4,7,9,9,27,Instinct
36,0,2,4,2,1,2,2,6,Valor
37,2,0,4,2,1,2,2,7,Mystic
38,0,2,6,4,1,3,3,9,Valor
39,12,0,14,2,6,7,7,22,Instinct
40,0,0,2,2,0,1,1,4,Valor
41,2,0,4,2,1,2,2,7,Mystic
42,0,2,4,2,1,2,2,6,Mystic
43,0,2,6,2,1,3,3,8,Valor
44,0,0,2,2,0,1,1,4,Valor
45,0,0,2,2,0,1,1,4,Valor
46,8,8,28,10,8,14,14,38,Instinct
47,8,6,26,8,7,13,13,35,Instinct
48,8,6,28,8,7,14,14,37,Instinct
49,0,2,4,2,1,2,2,6,Valor
50,8,0,10,2,4,5,5,16,Valor
51,14,4,22,4,9,11,11,32,Instinct
52,2,0,4,2,1,2,2,7,Mystic
53,12,6,26,6,9,13,13,36,Instinct
54,8,2,16,4,5,8,8,23,Valor
55,4,0,6,2,2,3,3,10,Valor
56,10,2,16,4,6,8,8,24,Mystic
57,2,6,20,8,4,10,10,26,Valor
58,2,2,6,2,2,3,3,9,Mystic
59,8,0,10,2,4,5,5,16,Mystic
60,4,0,6,2,2,3,3,10,Mystic
61,0,4,8,4,2,4,4,11,Valor
62,8,10,34,12,9,17,17,45,Instinct
63,6,0,8,2,3,4,4,13,Mystic
64,0,0,2,2,0,1,1,4,Mystic
65,4,0,6,2,2,3,3,10,Mystic
66,6,0,8,2,3,4,4,13,Mystic
67,0,4,10,4,2,5,5,13,Valor
68,4,0,6,2,2,3,3,10,Mystic
69,2,0,4,2,1,2,2,7,Mystic
70,2,0,4,2,1,2,2,7,Valor
71,8,6,32,8,7,16,16,41,Instinct
72,6,2,14,4,4,7,7,20,Mystic
73,4,2,8,2,3,4,4,12,Mystic
74,6,0,8,2,3,4,4,13,Mystic
75,12,8,30,8,10,15,15,41,Instinct
76,0,0,2,2,0,1,1,4,Mystic
77,0,0,2,2,0,1,1,4,Mystic
78,22,2,28,4,12,14,14,42,Instinct
79,0,4,8,4,2,4,4,11,Valor
80,6,0,8,2,3,4,4,13,Mystic
81,6,0,8,2,3,4,4,13,Valor
82,6,2,12,4,4,6,6,18,Mystic
83,4,4,16,4,4,8,8,21,Mystic
84,10,8,34,10,9,17,17,45,Instinct
85,6,0,8,2,3,4,4,13,Valor
86,8,2,12,2,5,6,6,18,Mystic
87,2,4,12,6,3,6,6,17,Mystic
88,10,0,12,2,5,6,6,19,Mystic
89,10,6,22,6,8,11,11,31,Instinct
90,14,2,20,4,8,10,10,30,Instinct
91,0,2,4,2,1,2,2,6,Mystic
92,14,0,16,2,7,8,8,25,Instinct
93,0,0,2,2,0,1,1,4,Mystic
94,16,4,28,4,10,14,14,39,Instinct
95,8,6,26,8,7,13,13,35,Instinct
96,0,2,6,2,1,3,3,8,Mystic
97,10,4,20,6,7,10,10,29,Instinct
98,0,0,2,2,0,1,1,4,Mystic
99,2,0,4,2,1,2,2,7,Valor
100,0,0,2,2,0,1,1,4,Mystic
101,0,2,6,2,1,3,3,8,Mystic
102,14,6,28,6,10,14,14,39,Instinct
103,10,8,32,8,9,16,16,42,Instinct
104,0,0,2,2,0,1,1,4,Valor
105,0,2,4,2,1,2,2,6,Valor
106,12,2,18,4,7,9,9,27,Instinct
107,0,0,2,2,0,1,1,4,Mystic
108,4,0,6,2,2,3,3,10,Valor
109,14,4,22,4,9,11,11,32,Instinct
110,2,0,4,2,1,2,2,7,Valor
111,0,0,2,2,0,1,1,4,Mystic
112,12,4,24,6,8,12,12,34,Instinct
113,4,0,6,2,2,3,3,10,Mystic
114,0,0,2,2,0,1,1,4,Mystic
115,0,2,4,2,1,2,2,6,Valor
116,8,8,28,8,8,14,14,37,Instinct
117,0,0,2,2,0,1,1,4,Mystic
118,2,0,4,2,1,2,2,7,Mystic
119,2,0,4,2,1,2,2,7,Mystic
120,0,0,2,2,0,1,1,4,Valor
121,16,4,26,6,10,13,13,38,Instinct
122,0,2,4,2,1,2,2,6,Valor
123,12,4,26,6,8,13,13,36,Instinct
124,14,0,16,2,7,8,8,25,Instinct
125,0,0,2,2,0,1,1,4,Valor
126,12,4,22,6,8,11,11,32,Instinct
127,0,0,2,2,0,1,1,4,Mystic
128,0,2,6,4,1,3,3,9,Valor
129,14,2,20,4,8,10,10,30,Instinct
130,0,0,2,2,0,1,1,4,Mystic
131,0,0,2,2,0,1,1,4,Mystic
132,4,2,8,2,3,4,4,12,Mystic
133,4,2,8,2,3,4,4,12,Mystic
134,4,0,6,2,2,3,3,10,Valor
135,8,6,22,6,7,11,11,30,Instinct
136,14,4,28,6,9,14,14,39,Instinct
137,0,2,8,2,1,4,4,10,Mystic
138,0,0,2,2,0,1,1,4,Valor
139,0,2,4,2,1,2,2,6,Valor
140,2,0,4,2,1,2,2,7,Valor
141,0,0,2,2,0,1,1,4,Valor
142,0,2,4,2,1,2,2,6,Valor
143,8,8,24,8,8,12,12,33,Instinct
144,0,0,2,2,0,1,1,4,Valor
145,0,0,2,2,0,1,1,4,Valor
146,2,0,4,2,1,2,2,7,Mystic
147,22,2,28,4,12,14,14,42,Instinct
148,10,8,30,8,9,15,15,40,Instinct
149,12,10,34,10,11,17,17,46,Instinct
150,4,4,14,4,4,7,7,19,Valor
151,0,0,2,2,0,1,1,4,Valor
152,0,2,6,4,1,3,3,9,Mystic
153,6,10,36,12,8,18,18,46,Instinct
154,14,4,22,4,9,11,11,32,Instinct
155,0,0,2,2,0,1,1,4,Mystic
156,6,8,30,10,7,15,15,39,Instinct
157,4,0,6,2,2,3,3,10,Valor
158,4,2,8,2,3,4,4,12,Valor
159,0,2,6,4,1,3,3,9,Mystic
160,0,0,2,2,0,1,1,4,Mystic
161,2,0,4,2,1,2,2,7,Mystic
162,12,8,34,10,10,17,17,46,Instinct
163,4,0,6,2,2,3,3,10,Mystic
164,2,0,4,2,1,2,2,7,Valor
165,0,2,6,4,1,3,3,9,Valor
166,14,2,20,4,8,10,10,30,Instinct
167,0,2,8,2,1,4,4,10,Valor
168,4,8,36,10,6,18,18,44,Instinct
169,0,0,2,2,0,1,1,4,Valor
170,4,2,10,4,3,5,5,15,Mystic
171,0,2,6,4,1,3,3,9,Mystic
172,12,6,26,8,9,13,13,37,Instinct
173,6,2,14,4,4,7,7,20,Mystic
174,12,6,24,6,9,12,12,34,Instinct
175,12,4,24,6,8,12,12,34,Instinct
176,12,6,26,6,9,13,13,36,Instinct
177,2,2,8,4,2,4,4,12,Valor
178,4,0,6,2,2,3,3,10,Mystic
179,2,2,6,2,2,3,3,9,Valor
180,0,0,2,2,0,1,1,4,Valor
181,6,2,12,4,4,6,6,18,Mystic
182,0,0,2,2,0,1,1,4,Mystic
183,2,0,4,2,1,2,2,7,Mystic
184,6,0,8,2,3,4,4,13,Mystic
185,0,2,4,2,1,2,2,6,Valor
186,4,4,16,4,4,8,8,21,Valor
187,14,0,16,2,7,8,8,25,Mystic
188,8,4,16,4,6,8,8,23,Valor
189,0,2,4,2,1,2,2,6,Valor
190,0,0,2,2,0,1,1,4,Valor
191,0,0,2,2,0,1,1,4,Valor
192,2,2,8,4,2,4,4,12,Mystic
193,2,0,4,2,1,2,2,7,Valor
194,14,4,22,4,9,11,11,32,Instinct
195,12,4,26,6,8,13,13,36,Instinct
196,0,2,4,2,1,2,2,6,Valor
197,0,0,2,2,0,1,1,4,Valor
198,2,0,4,2,1,2,2,7,Mystic
199,10,4,24,6,7,12,12,33,Instinct
200,0,0,2,2,0,1,1,4,Valor
201,0,0,2,2,0,1,1,4,Valor
202,2,2,8,4,2,4,4,12,Valor
203,0,0,2,2,0,1,1,4,Valor
204,0,0,2,2,0,1,1,4,Mystic
205,0,2,4,2,1,2,2,6,Valor
206,2,0,4,2,1,2,2,7,Mystic
207,16,2,22,4,9,11,11,33,Instinct
208,6,6,22,8,6,11,11,30,Instinct
209,0,2,4,2,1,2,2,6,Valor
210,12,6,28,8,9,14,14,39,Instinct
211,0,2,4,2,1,2,2,6,Mystic
212,4,8,32,10,6,16,16,40,Instinct
213,0,2,4,2,1,2,2,6,Valor
214,14,2,20,4,8,10,10,30,Instinct
215,2,0,4,2,1,2,2,7,Valor
216,0,0,2,2,0,1,1,4,Mystic
217,14,4,26,6,9,13,13,37,Instinct
218,0,0,2,2,0,1,1,4,Mystic
219,14,2,20,4,8,10,10,30,Instinct
220,0,2,4,2,1,2,2,6,Valor
221,0,2,6,2,1,3,3,8,Mystic
222,0,2,6,4,1,3,3,9,Valor
223,12,4,22,6,8,11,11,32,Instinct
224,12,4,24,6,8,12,12,34,Instinct
225,20,2,26,4,11,13,13,39,Instinct
226,0,2,4,2,1,2,2,6,Mystic
227,0,0,2,2,0,1,1,4,Mystic
228,14,4,26,6,9,13,13,37,Instinct
229,6,8,28,8,7,14,14,36,Instinct
230,0,2,4,2,1,2,2,6,Mystic
231,0,0,2,2,0,1,1,4,Valor
232,0,2,6,4,1,3,3,9,Valor
233,8,6,26,8,7,13,13,35,Instinct
234,0,2,6,4,1,3,3,9,Mystic
235,0,2,4,2,1,2,2,6,Valor
236,0,0,2,2,0,1,1,4,Mystic
237,0,0,2,2,0,1,1,4,Mystic
238,20,2,26,4,11,13,13,39,Instinct
239,0,0,2,2,0,1,1,4,Valor
240,0,0,2,2,0,1,1,4,Mystic
241,2,0,4,2,1,2,2,7,Valor
242,0,0,2,2,0,1,1,4,Valor
243,10,2,18,4,6,9,9,26,Instinct
244,8,6,30,8,7,15,15,39,Instinct
245,0,2,6,2,1,3,3,8,Mystic
246,0,2,4,2,1,2,2,6,Valor
247,16,0,18,2,8,9,9,28,Instinct
248,10,6,28,8,8,14,14,38,Instinct
249,0,0,2,2,0,1,1,4,Valor
250,20,4,30,4,12,15,15,43,Instinct
251,10,6,28,8,8,14,14,38,Instinct
252,10,6,30,8,8,15,15,40,Instinct
253,0,0,2,2,0,1,1,4,Valor
254,0,2,4,2,1,2,2,6,Valor
255,10,8,28,10,9,14,14,39,Instinct
256,0,0,2,2,0,1,1,4,Mystic
257,2,0,4,2,1,2,2,7,Mystic
258,12,2,18,4,7,9,9,27,Instinct
259,2,0,4,2,1,2,2,7,Mystic
260,12,2,16,2,7,8,8,24,Instinct
261,20,2,28,4,11,14,14,41,Instinct
262,14,2,20,4,8,10,10,30,Instinct
263,0,2,4,2,1,2,2,6,Mystic
264,2,0,4,2,1,2,2,7,Mystic
265,14,2,20,4,8,10,10,30,Instinct
266,14,4,26,6,9,13,13,37,Instinct
267,0,2,4,2,1,2,2,6,Mystic
268,12,4,22,6,8,11,11,32,Instinct
269,12,2,18,4,7,9,9,27,Instinct
270,8,0,10,2,4,5,5,16,Valor
271,2,0,4,2,1,2,2,7,Valor
272,8,0,10,2,4,5,5,16,Valor
273,4,4,14,4,4,7,7,19,Valor
274,2,0,4,2,1,2,2,7,Valor
275,4,0,6,2,2,3,3,10,Mystic
276,6,2,10,2,4,5,5,15,Valor
277,2,2,6,2,2,3,3,9,Valor
278,8,2,16,4,5,8,8,23,Mystic
279,16,2,22,4,9,11,11,33,Instinct
280,6,0,8,2,3,4,4,13,Valor
281,0,2,6,4,1,3,3,9,Valor
282,2,0,4,2,1,2,2,7,Valor
283,2,0,4,2,1,2,2,7,Valor
284,4,0,6,2,2,3,3,10,Valor
285,8,2,12,2,5,6,6,18,Mystic
286,18,2,26,4,10,13,13,38,Instinct
287,16,4,26,6,10,13,13,38,Instinct
288,10,4,24,6,7,12,12,33,Instinct
289,16,6,32,8,11,16,16,45,Instinct
290,4,2,8,2,3,4,4,12,Valor
291,12,4,24,6,8,12,12,34,Instinct
292,0,0,2,2,0,1,1,4,Valor
293,8,6,22,8,7,11,11,31,Instinct
294,14,8,30,8,11,15,15,42,Instinct
295,4,2,8,2,3,4,4,12,Valor
296,12,0,14,2,6,7,7,22,Mystic
297,8,0,10,2,4,5,5,16,Mystic
298,0,0,2,2,0,1,1,4,Valor
299,18,0,20,2,9,10,10,31,Instinct
300,14,2,18,2,8,9,9,27,Instinct
301,4,0,6,2,2,3,3,10,Mystic
302,4,2,12,4,3,6,6,17,Mystic
303,2,0,4,2,1,2,2,7,Valor
304,0,0,2,2,0,1,1,4,Valor
305,10,2,14,2,6,7,7,21,Mystic
306,0,0,2,2,0,1,1,4,Mystic
307,12,4,22,6,8,11,11,32,Instinct
308,2,2,8,4,2,4,4,12,Valor
309,18,2,24,4,10,12,12,36,Instinct
310,6,2,12,4,4,6,6,18,Mystic
311,8,2,14,4,5,7,7,21,Mystic
312,12,6,28,8,9,14,14,39,Instinct
313,2,2,8,4,2,4,4,12,Valor
314,2,2,8,2,2,4,4,11,Valor
315,0,2,6,4,1,3,3,9,Valor
316,12,2,18,4,7,9,9,27,Mystic
317,0,0,2,2,0,1,1,4,Mystic
318,2,2,8,4,2,4,4,12,Mystic
319,2,2,6,2,2,3,3,9,Valor
320,0,0,2,2,0,1,1,4,Mystic
321,6,0,8,2,3,4,4,13,Valor
322,0,2,6,4,1,3,3,9,Valor
323,4,2,10,4,3,5,5,15,Valor
324,14,4,28,6,9,14,14,39,Instinct
325,8,0,10,2,4,5,5,16,Mystic
326,10,2,14,2,6,7,7,21,Valor
327,4,2,10,2,3,5,5,14,Valor
328,0,2,4,2,1,2,2,6,Valor
329,12,4,24,6,8,12,12,34,Instinct
330,10,6,24,6,8,12,12,33,Instinct
331,8,0,10,2,4,5,5,16,Valor
332,10,4,26,6,7,13,13,35,Instinct
333,0,2,6,2,1,3,3,8,Mystic
334,0,2,6,4,1,3,3,9,Valor
335,4,0,6,2,2,3,3,10,Valor
336,0,2,6,4,1,3,3,9,Mystic
337,2,0,4,2,1,2,2,7,Mystic
338,4,0,6,2,2,3,3,10,Valor
339,14,4,26,6,9,13,13,37,Instinct
340,6,0,8,2,3,4,4,13,Mystic
341,8,8,28,10,8,14,14,38,Instinct
342,4,2,8,2,3,4,4,12,Valor
343,14,2,20,4,8,10,10,30,Instinct
344,10,4,24,6,7,12,12,33,Instinct
345,4,2,10,2,3,5,5,14,Valor
346,2,4,12,6,3,6,6,17,Valor
347,0,2,4,2,1,2,2,6,Valor
348,0,2,4,2,1,2,2,6,Mystic
349,4,0,6,2,2,3,3,10,Mystic
350,10,6,24,8,8,12,12,34,Instinct
351,10,4,20,6,7,10,10,29,Instinct
352,8,8,30,10,8,15,15,40,Instinct
353,8,4,20,6,6,10,10,28,Instinct
354,14,0,16,2,7,8,8,25,Instinct
355,0,0,2,2,0,1,1,4,Valor
356,0,2,4,2,1,2,2,6,Valor
357,8,4,18,6,6,9,9,26,Instinct
358,4,2,10,4,3,5,5,15,Instinct
359,14,4,22,4,9,11,11,32,Instinct
360,0,2,4,2,1,2,2,6,Mystic
361,12,2,18,2,7,9,9,26,Instinct
362,0,0,2,2,0,1,1,4,Mystic
363,0,0,2,2,0,1,1,4,Valor
364,2,0,4,2,1,2,2,7,Mystic
365,0,0,2,2,0,1,1,4,Valor
366,12,0,14,2,6,7,7,22,Instinct
367,4,0,6,2,2,3,3,10,Mystic
368,0,0,2,2,0,1,1,4,Valor
369,0,0,2,2,0,1,1,4,Valor
370,16,0,18,2,8,9,9,28,Instinct
371,4,0,6,2,2,3,3,10,Valor
372,0,2,4,2,1,2,2,6,Valor
373,12,4,24,6,8,12,12,34,Instinct
374,12,4,22,6,8,11,11,32,Instinct
375,0,2,6,4,1,3,3,9,Mystic
376,14,0,16,2,7,8,8,25,Instinct
377,0,0,2,2,0,1,1,4,Valor
378,0,2,6,4,1,3,3,9,Mystic
379,8,8,30,10,8,15,15,40,Instinct
380,0,2,4,2,1,2,2,6,Mystic
381,0,0,2,2,0,1,1,4,Valor
382,0,2,4,2,1,2,2,6,Valor
383,12,2,18,4,7,9,9,27,Instinct
384,18,0,20,2,9,10,10,31,Instinct
385,0,0,2,2,0,1,1,4,Mystic
386,12,6,30,8,9,15,15,41,Instinct
387,0,0,2,2,0,1,1,4,Valor
388,0,2,6,4,1,3,3,9,Mystic
389,0,0,2,2,0,1,1,4,Mystic
390,0,0,2,2,0,1,1,4,Mystic
391,0,2,6,4,1,3,3,9,Valor
392,4,0,6,2,2,3,3,10,Mystic
393,0,0,2,2,0,1,1,4,Valor
394,0,0,2,2,0,1,1,4,Mystic
395,14,4,24,6,9,12,12,35,Instinct
396,14,4,24,6,9,12,12,35,Instinct
397,4,0,6,2,2,3,3,10,Mystic
398,10,8,32,10,9,16,16,43,Instinct
399,0,2,8,2,1,4,4,10,Mystic
400,12,6,24,6,9,12,12,34,Instinct
401,4,0,6,2,2,3,3,10,Valor
402,0,2,4,2,1,2,2,6,Valor
403,6,8,26,10,7,13,13,35,Instinct
404,0,2,4,2,1,2,2,6,Valor
405,2,0,4,2,1,2,2,7,Valor
406,2,0,4,2,1,2,2,7,Mystic
407,16,2,24,4,9,12,12,35,Instinct
408,0,2,4,2,1,2,2,6,Mystic
409,0,2,6,2,1,3,3,8,Mystic
410,14,2,20,4,8,10,10,30,Instinct
411,6,0,8,2,3,4,4,13,Mystic
412,0,2,4,2,1,2,2,6,Valor
413,6,0,8,2,3,4,4,13,Mystic
414,0,2,6,2,1,3,3,8,Valor
415,0,0,2,2,0,1,1,4,Mystic
416,12,4,22,6,8,11,11,32,Instinct
417,12,2,22,4,7,11,11,31,Instinct
418,0,2,6,4,1,3,3,9,Valor
419,4,2,10,4,3,5,5,15,Valor
420,10,4,20,6,7,10,10,29,Instinct
421,4,0,6,2,2,3,3,10,Mystic
422,4,0,6,2,2,3,3,10,Mystic
423,2,2,6,2,2,3,3,9,Valor
424,6,0,8,2,3,4,4,13,Mystic
425,2,0,4,2,1,2,2,7,Mystic
426,2,2,10,4,2,5,5,14,Mystic
427,12,6,30,8,9,15,15,41,Instinct
428,16,2,24,4,9,12,12,35,Instinct
429,6,2,12,4,4,6,6,18,Mystic
430,0,2,6,4,1,3,3,9,Mystic
431,0,2,4,2,1,2,2,6,Valor
432,0,2,6,4,1,3,3,9,Valor
433,6,0,8,2,3,4,4,13,Mystic
434,2,4,12,6,3,6,6,17,Mystic
435,16,6,30,8,11,15,15,43,Instinct
436,10,4,28,6,7,14,14,37,Instinct
437,2,0,4,2,1,2,2,7,Valor
438,6,0,8,2,3,4,4,13,Valor
439,12,4,24,6,8,12,12,34,Instinct
440,16,4,28,6,10,14,14,40,Instinct
441,6,8,30,10,7,15,15,39,Instinct
442,2,0,4,2,1,2,2,7,Mystic
443,2,0,4,2,1,2,2,7,Valor
444,2,0,4,2,1,2,2,7,Valor
445,2,0,4,2,1,2,2,7,Mystic
446,20,6,32,6,13,16,16,46,Instinct
447,4,0,6,2,2,3,3,10,Mystic
448,18,6,36,8,12,18,18,50,Instinct
449,8,6,22,8,7,11,11,31,Instinct
450,18,8,38,10,13,19,19,53,Instinct
451,0,0,2,2,0,1,1,4,Mystic
452,2,0,4,2,1,2,2,7,Mystic
453,8,0,10,2,4,5,5,16,Mystic
454,12,4,22,6,8,11,11,32,Instinct
455,0,2,4,2,1,2,2,6,Valor
456,0,0,2,2,0,1,1,4,Valor
457,18,4,32,6,11,16,16,45,Instinct
458,4,2,10,4,3,5,5,15,Mystic
459,2,0,4,2,1,2,2,7,Mystic
460,0,4,8,4,2,4,4,11,Valor
461,0,0,2,2,0,1,1,4,Mystic
462,6,10,30,10,8,15,15,39,Instinct
463,2,0,4,2,1,2,2,7,Mystic
464,2,4,10,4,3,5,5,14,Mystic
465,0,0,2,2,0,1,1,4,Valor
466,8,6,24,8,7,12,12,33,Instinct
467,0,0,2,2,0,1,1,4,Mystic
468,14,2,20,4,8,10,10,30,Instinct
469,8,6,22,8,7,11,11,31,Instinct
470,4,2,8,2,3,4,4,12,Valor
471,6,6,20,8,6,10,10,28,Instinct
472,2,0,4,2,1,2,2,7,Mystic
473,0,2,6,2,1,3,3,8,Valor
474,0,0,2,2,0,1,1,4,Mystic
475,12,10,32,10,11,16,16,44,Instinct
476,2,0,4,2,1,2,2,7,Valor
477,6,8,34,10,7,17,17,43,Instinct
478,2,2,8,4,2,4,4,12,Valor
479,0,0,2,2,0,1,1,4,Valor
480,6,0,8,2,3,4,4,13,Mystic
481,12,4,22,6,8,11,11,32,Instinct
482,4,0,6,2,2,3,3,10,Valor
483,0,0,2,2,0,1,1,4,Mystic
484,0,0,2,2,0,1,1,4,Valor
485,14,6,28,8,10,14,14,40,Instinct
486,16,2,22,4,9,11,11,33,Instinct
487,2,0,4,2,1,2,2,7,Mystic
488,6,0,8,2,3,4,4,13,Valor
489,12,6,26,8,9,13,13,37,Instinct
490,0,0,2,2,0,1,1,4,Mystic
491,10,4,20,6,7,10,10,29,Instinct
492,6,0,8,2,3,4,4,13,Mystic
493,0,0,2,2,0,1,1,4,Valor
494,4,2,10,4,3,5,5,15,Valor
495,4,0,6,2,2,3,3,10,Valor
496,0,0,2,2,0,1,1,4,Valor
497,2,4,14,6,3,7,7,19,Mystic
498,0,2,4,2,1,2,2,6,Valor
499,8,0,10,2,4,5,5,16,Mystic
500,10,0,12,2,5,6,6,19,Mystic
501,12,4,26,6,8,13,13,36,Instinct
502,0,0,2,2,0,1,1,4,Valor
503,2,2,8,4,2,4,4,12,Valor
504,4,0,6,2,2,3,3,10,Mystic
505,4,0,6,2,2,3,3,10,Valor
506,8,0,10,2,4,5,5,16,Mystic
507,6,10,36,12,8,18,18,46,Instinct
508,18,6,40,8,12,20,20,54,Instinct
509,2,0,4,2,1,2,2,7,Mystic
510,10,6,32,8,8,16,16,42,Instinct
511,16,4,28,6,10,14,14,40,Instinct
512,4,0,6,2,2,3,3,10,Mystic
513,2,0,4,2,1,2,2,7,Mystic
514,6,0,8,2,3,4,4,13,Mystic
515,6,0,8,2,3,4,4,13,Valor
516,0,2,10,2,1,5,5,12,Mystic
517,4,2,10,4,3,5,5,15,Mystic
518,4,2,10,4,3,5,5,15,Mystic
519,20,4,30,6,12,15,15,44,Instinct
520,2,0,4,2,1,2,2,7,Valor
521,2,2,12,4,2,6,6,16,Valor
522,0,0,2,2,0,1,1,4,Valor
523,4,0,6,2,2,3,3,10,Valor
524,2,2,10,4,2,5,5,14,Mystic
525,0,2,12,4,1,6,6,15,Valor
526,0,4,10,4,2,5,5,13,Valor
527,0,2,6,4,1,3,3,9,Valor
528,4,0,6,2,2,3,3,10,Mystic
529,12,4,22,6,8,11,11,32,Instinct
530,16,8,34,10,12,17,17,48,Instinct
531,4,2,8,2,3,4,4,12,Valor
532,6,2,12,4,4,6,6,18,Valor
533,6,0,8,2,3,4,4,13,Mystic
534,4,0,6,2,2,3,3,10,Valor
535,18,6,32,8,12,16,16,46,Instinct
536,10,0,12,2,5,6,6,19,Mystic
537,2,2,12,4,2,6,6,16,Valor
538,4,0,6,2,2,3,3,10,Mystic
539,6,2,14,4,4,7,7,20,Valor
540,22,4,32,6,13,16,16,47,Instinct
541,4,2,10,4,3,5,5,15,Mystic
542,16,2,22,4,9,11,11,33,Instinct
543,0,2,6,4,1,3,3,9,Valor
544,2,2,6,2,2,3,3,9,Valor
545,10,10,32,10,10,16,16,43,Instinct
546,4,0,6,2,2,3,3,10,Mystic
547,20,0,22,2,10,11,11,34,Instinct
548,2,0,4,2,1,2,2,7,Valor
549,0,2,6,4,1,3,3,9,Mystic
550,0,0,2,2,0,1,1,4,Valor
551,10,4,24,6,7,12,12,33,Instinct
552,0,0,2,2,0,1,1,4,Mystic
553,0,2,6,2,1,3,3,8,Valor
554,16,2,22,4,9,11,11,33,Instinct
555,14,2,20,4,8,10,10,30,Instinct
556,2,2,6,2,2,3,3,9,Valor
557,2,0,4,2,1,2,2,7,Mystic
558,18,4,28,6,11,14,14,41,Instinct
559,22,4,34,4,13,17,17,48,Instinct
560,4,8,24,10,6,12,12,32,Instinct
561,14,2,20,4,8,10,10,30,Instinct
562,0,0,2,2,0,1,1,4,Valor
563,2,0,4,2,1,2,2,7,Valor
564,2,0,4,2,1,2,2,7,Mystic
565,0,2,4,2,1,2,2,6,Valor
566,10,6,24,8,8,12,12,34,Instinct
567,0,0,2,2,0,1,1,4,Valor
568,0,0,2,2,0,1,1,4,Mystic
569,18,2,24,4,10,12,12,36,Instinct
570,4,0,6,2,2,3,3,10,Mystic
571,0,0,2,2,0,1,1,4,Valor
572,0,2,4,2,1,2,2,6,Mystic
573,0,0,2,2,0,1,1,4,Mystic
574,2,0,4,2,1,2,2,7,Mystic
575,0,0,2,2,0,1,1,4,Mystic
576,14,2,20,4,8,10,10,30,Instinct
577,4,2,8,2,3,4,4,12,Mystic
578,0,0,2,2,0,1,1,4,Mystic
579,10,4,22,6,7,11,11,31,Instinct
580,8,6,32,8,7,16,16,41,Instinct
581,0,0,2,2,0,1,1,4,Mystic
582,10,6,24,8,8,12,12,34,Instinct
583,0,2,6,4,1,3,3,9,Valor
584,18,6,32,6,12,16,16,45,Instinct
585,0,0,2,2,0,1,1,4,Mystic
586,16,4,24,4,10,12,12,35,Instinct
587,0,0,2,2,0,1,1,4,Mystic
588,0,0,2,2,0,1,1,4,Mystic
589,0,0,2,2,0,1,1,4,Mystic
590,2,2,8,4,2,4,4,12,Mystic
591,12,2,18,4,7,9,9,27,Instinct
592,10,8,26,8,9,13,13,36,Instinct
593,6,0,8,2,3,4,4,13,Valor
594,2,0,4,2,1,2,2,7,Valor
595,4,2,10,4,3,5,5,15,Mystic
596,14,4,26,6,9,13,13,37,Instinct
597,12,4,22,6,8,11,11,32,Instinct
598,6,2,10,2,4,5,5,15,Mystic
599,8,0,10,2,4,5,5,16,Valor
600,2,4,10,4,3,5,5,14,Valor
601,0,0,2,2,0,1,1,4,Mystic
602,0,0,2,2,0,1,1,4,Mystic
603,10,6,26,8,8,13,13,36,Instinct
604,0,0,2,2,0,1,1,4,Mystic
605,0,2,4,2,1,2,2,6,Valor
606,0,2,6,4,1,3,3,9,Valor
607,18,2,24,4,10,12,12,36,Instinct
608,0,2,6,4,1,3,3,9,Valor
609,4,2,12,4,3,6,6,17,Mystic
610,4,0,6,2,2,3,3,10,Mystic
611,10,6,28,8,8,14,14,38,Instinct
612,2,0,4,2,1,2,2,7,Valor
613,0,2,4,2,1,2,2,6,Mystic
614,12,4,22,6,8,11,11,32,Instinct
615,2,0,4,2,1,2,2,7,Mystic
616,4,0,6,2,2,3,3,10,Mystic
617,0,2,4,2,1,2,2,6,Valor
618,2,2,8,4,2,4,4,12,Mystic
619,4,2,10,4,3,5,5,15,Valor
620,2,0,4,2,1,2,2,7,Valor
621,6,8,28,10,7,14,14,37,Instinct
622,12,4,22,6,8,11,11,32,Instinct
623,4,0,6,2,2,3,3,10,Mystic
624,2,2,6,2,2,3,3,9,Valor
625,2,0,4,2,1,2,2,7,Valor
626,6,8,28,10,7,14,14,37,Instinct
627,2,2,6,2,2,3,3,9,Valor
628,0,0,2,2,0,1,1,4,Valor
629,6,0,8,2,3,4,4,13,Valor
630,6,10,28,12,8,14,14,38,Instinct
631,4,6,20,6,5,10,10,26,Instinct
632,2,0,4,2,1,2,2,7,Mystic
633,0,0,2,2,0,1,1,4,Valor
634,0,0,2,2,0,1,1,4,Mystic
635,12,6,28,8,9,14,14,39,Instinct
636,2,0,4,2,1,2,2,7,Valor
637,0,2,4,2,1,2,2,6,Mystic
638,4,0,6,2,2,3,3,10,Mystic
639,8,6,22,8,7,11,11,31,Instinct
640,0,0,2,2,0,1,1,4,Valor
641,16,0,18,2,8,9,9,28,Instinct
642,0,2,4,2,1,2,2,6,Mystic
643,14,2,20,4,8,10,10,30,Instinct
644,0,0,2,2,0,1,1,4,Valor
645,0,2,4,2,1,2,2,6,Mystic
646,0,2,6,2,1,3,3,8,Valor
647,0,0,2,2,0,1,1,4,Mystic
648,4,0,6,2,2,3,3,10,Valor
649,0,0,2,2,0,1,1,4,Mystic
650,16,2,26,4,9,13,13,37,Instinct
651,16,0,18,2,8,9,9,28,Instinct
652,2,0,4,2,1,2,2,7,Valor
653,0,2,4,2,1,2,2,6,Mystic
654,4,4,14,6,4,7,7,20,Instinct
655,0,2,4,2,1,2,2,6,Mystic
656,0,0,2,2,0,1,1,4,Valor
657,14,4,24,6,9,12,12,35,Instinct
658,8,2,14,4,5,7,7,21,Instinct
659,2,6,18,8,4,9,9,24,Instinct
660,0,0,2,2,0,1,1,4,Mystic
661,0,2,4,2,1,2,2,6,Valor
662,16,0,18,2,8,9,9,28,Instinct
663,12,4,22,6,8,11,11,32,Instinct
664,0,2,4,2,1,2,2,6,Mystic
665,12,0,14,2,6,7,7,22,Instinct
666,0,2,6,2,1,3,3,8,Mystic
667,12,4,22,6,8,11,11,32,Instinct
668,18,0,20,2,9,10,10,31,Instinct
669,10,4,22,6,7,11,11,31,Instinct
670,6,0,8,2,3,4,4,13,Mystic
671,0,0,2,2,0,1,1,4,Valor
672,0,2,4,2,1,2,2,6,Valor
673,0,2,4,2,1,2,2,6,Mystic
674,0,2,6,4,1,3,3,9,Valor
675,4,0,6,2,2,3,3,10,Valor
676,6,0,8,2,3,4,4,13,Mystic
677,12,8,36,10,10,18,18,48,Instinct
678,0,0,2,2,0,1,1,4,Valor
679,2,0,4,2,1,2,2,7,Mystic
680,10,8,36,10,9,18,18,47,Instinct
681,4,2,12,4,3,6,6,17,Mystic
682,0,0,2,2,0,1,1,4,Valor
683,12,4,26,6,8,13,13,36,Instinct
684,18,2,24,4,10,12,12,36,Instinct
685,14,0,16,2,7,8,8,25,Instinct
686,4,2,12,4,3,6,6,17,Mystic
687,0,0,2,2,0,1,1,4,Mystic
688,8,2,14,4,5,7,7,21,Mystic
689,2,2,8,4,2,4,4,12,Valor
690,20,6,32,6,13,16,16,46,Instinct
691,0,0,2,2,0,1,1,4,Mystic
692,0,0,2,2,0,1,1,4,Mystic
693,4,0,6,2,2,3,3,10,Mystic
694,0,2,6,4,1,3,3,9,Valor
695,12,4,24,6,8,12,12,34,Instinct
696,0,2,4,2,1,2,2,6,Mystic
697,12,4,22,6,8,11,11,32,Instinct
698,2,0,4,2,1,2,2,7,Mystic
699,0,0,2,2,0,1,1,4,Mystic
700,2,0,4,2,1,2,2,7,Mystic
701,12,2,18,4,7,9,9,27,Instinct
702,2,0,4,2,1,2,2,7,Mystic
703,4,10,30,10,7,15,15,38,Instinct
704,0,0,2,2,0,1,1,4,Valor
705,10,6,24,8,8,12,12,34,Instinct
706,16,2,22,4,9,11,11,33,Instinct
707,0,2,4,2,1,2,2,6,Mystic
708,0,2,6,4,1,3,3,9,Valor
709,2,2,8,4,2,4,4,12,Valor
710,0,0,2,2,0,1,1,4,Valor
711,0,2,4,2,1,2,2,6,Valor
712,12,6,26,8,9,13,13,37,Instinct
713,12,4,22,6,8,11,11,32,Instinct
714,10,10,36,10,10,18,18,47,Instinct
715,16,6,32,8,11,16,16,45,Instinct
716,6,0,8,2,3,4,4,13,Valor
717,0,0,2,2,0,1,1,4,Valor
718,18,4,28,6,11,14,14,41,Instinct
719,4,2,10,4,3,5,5,15,Mystic
720,4,0,6,2,2,3,3,10,Mystic
721,2,0,4,2,1,2,2,7,Valor
722,2,0,4,2,1,2,2,7,Valor
723,0,0,2,2,0,1,1,4,Valor
724,6,10,34,10,8,17,17,43,Instinct
725,0,2,4,2,1,2,2,6,Valor
726,0,0,2,2,0,1,1,4,Mystic
727,2,0,4,2,1,2,2,7,Valor
728,4,2,8,2,3,4,4,12,Mystic
729,20,2,28,4,11,14,14,41,Instinct
730,2,0,4,2,1,2,2,7,Mystic
731,2,4,16,4,3,8,8,20,Valor
732,16,2,22,4,9,11,11,33,Instinct
733,20,2,28,4,11,14,14,41,Instinct
734,0,0,2,2,0,1,1,4,Valor
735,0,0,2,2,0,1,1,4,Valor
736,2,0,4,2,1,2,2,7,Valor
737,0,2,4,2,1,2,2,6,Valor
738,14,6,28,8,10,14,14,40,Instinct
739,8,2,16,4,5,8,8,23,Valor
740,0,2,4,2,1,2,2,6,Mystic
741,8,8,26,8,8,13,13,35,Instinct
742,10,0,12,2,5,6,6,19,Mystic
743,0,0,2,2,0,1,1,4,Valor
744,8,0,10,2,4,5,5,16,Mystic
745,0,0,2,2,0,1,1,4,Mystic
746,4,0,6,2,2,3,3,10,Mystic
747,4,0,6,2,2,3,3,10,Mystic
748,2,0,4,2,1,2,2,7,Valor
749,4,8,26,10,6,13,13,34,Instinct
750,2,0,4,2,1,2,2,7,Mystic
751,2,2,10,4,2,5,5,14,Mystic
752,6,0,8,2,3,4,4,13,Valor
753,10,0,12,2,5,6,6,19,Mystic
754,2,2,10,4,2,5,5,14,Valor
755,0,2,4,2,1,2,2,6,Valor
756,2,0,4,2,1,2,2,7,Valor
757,4,2,12,4,3,6,6,17,Valor
758,0,0,2,2,0,1,1,4,Mystic
759,0,2,6,2,1,3,3,8,Mystic
760,8,6,24,8,7,12,12,33,Instinct
761,0,0,2,2,0,1,1,4,Valor
762,16,2,24,4,9,12,12,35,Instinct
763,2,0,4,2,1,2,2,7,Valor
764,2,0,4,2,1,2,2,7,Valor
765,0,2,6,2,1,3,3,8,Valor
766,20,0,22,2,10,11,11,34,Instinct
767,4,0,6,2,2,3,3,10,Mystic
768,2,2,10,4,2,5,5,14,Mystic
769,8,0,10,2,4,5,5,16,Mystic
770,16,0,18,2,8,9,9,28,Instinct
771,8,2,14,4,5,7,7,21,Instinct
772,4,10,34,12,7,17,17,43,Instinct
773,0,2,4,2,1,2,2,6,Mystic
774,0,2,4,2,1,2,2,6,Valor
775,10,4,18,4,7,9,9,26,Instinct
776,4,0,6,2,2,3,3,10,Valor
777,0,0,2,2,0,1,1,4,Mystic
778,2,0,4,2,1,2,2,7,Valor
779,0,2,8,2,1,4,4,10,Mystic
780,14,2,20,4,8,10,10,30,Instinct
781,2,0,4,2,1,2,2,7,Mystic
782,0,4,12,4,2,6,6,15,Valor
783,0,0,2,2,0,1,1,4,Valor
784,14,0,16,2,7,8,8,25,Instinct
785,14,4,24,6,9,12,12,35,Instinct
786,6,0,8,2,3,4,4,13,Instinct
787,2,4,12,4,3,6,6,16,Mystic
788,0,0,2,2,0,1,1,4,Mystic
789,12,4,22,6,8,11,11,32,Instinct
790,2,0,4,2,1,2,2,7,Mystic
791,0,0,2,2,0,1,1,4,Mystic
792,0,0,2,2,0,1,1,4,Mystic
793,0,0,2,2,0,1,1,4,Valor
794,0,0,2,2,0,1,1,4,Mystic
795,20,0,22,2,10,11,11,34,Instinct
796,0,0,2,2,0,1,1,4,Mystic
797,12,4,26,6,8,13,13,36,Instinct
798,4,0,6,2,2,3,3,10,Mystic
799,0,0,2,2,0,1,1,4,Mystic
800,16,0,18,2,8,9,9,28,Instinct
801,6,8,30,10,7,15,15,39,Instinct
802,18,0,20,2,9,10,10,31,Instinct
803,0,0,2,2,0,1,1,4,Mystic
804,14,0,16,2,7,8,8,25,Instinct
805,0,0,2,2,0,1,1,4,Mystic
806,2,4,12,4,3,6,6,16,Mystic
807,18,2,24,4,10,12,12,36,Instinct
808,12,4,24,6,8,12,12,34,Instinct
809,0,2,6,4,1,3,3,9,Valor
810,0,2,6,4,1,3,3,9,Valor
811,12,6,26,8,9,13,13,37,Instinct
812,0,2,6,4,1,3,3,9,Valor
813,0,0,2,2,0,1,1,4,Valor
814,10,8,30,10,9,15,15,41,Instinct
815,8,8,26,8,8,13,13,35,Instinct
816,0,0,2,2,0,1,1,4,Valor
817,18,6,30,6,12,15,15,43,Instinct
818,2,0,4,2,1,2,2,7,Valor
819,0,2,6,4,1,3,3,9,Valor
820,2,2,8,4,2,4,4,12,Valor
821,6,0,8,2,3,4,4,13,Mystic
822,0,0,2,2,0,1,1,4,Mystic
823,6,0,8,2,3,4,4,13,Mystic
824,14,4,26,6,9,13,13,37,Instinct
825,6,0,8,2,3,4,4,13,Mystic
826,2,0,4,2,1,2,2,7,Valor
827,2,2,8,2,2,4,4,11,Valor
828,6,4,16,6,5,8,8,23,Mystic
829,4,0,6,2,2,3,3,10,Valor
830,4,0,6,2,2,3,3,10,Mystic
831,0,0,2,2,0,1,1,4,Valor
832,18,0,20,2,9,10,10,31,Instinct
833,2,2,8,4,2,4,4,12,Valor
834,6,8,30,10,7,15,15,39,Instinct
835,0,4,10,4,2,5,5,13,Valor
836,18,2,24,2,10,12,12,35,Instinct
837,0,2,4,2,1,2,2,6,Mystic
838,8,0,10,2,4,5,5,16,Mystic
839,0,0,2,2,0,1,1,4,Mystic
840,18,2,22,2,10,11,11,33,Instinct
841,4,2,10,2,3,5,5,14,Valor
842,8,0,10,2,4,5,5,16,Mystic
843,0,2,4,2,1,2,2,6,Mystic
844,14,2,22,4,8,11,11,32,Instinct
845,16,2,22,4,9,11,11,33,Instinct
846,0,0,2,2,0,1,1,4,Mystic
847,6,0,8,2,3,4,4,13,Valor
848,2,0,4,2,1,2,2,7,Valor
849,2,0,4,2,1,2,2,7,Valor
850,12,4,20,4,8,10,10,29,Instinct
851,2,2,8,4,2,4,4,12,Mystic
852,12,8,40,10,10,20,20,52,Instinct
853,4,0,6,2,2,3,3,10,Valor
854,8,6,24,6,7,12,12,32,Instinct
855,2,0,4,2,1,2,2,7,Mystic
856,16,4,28,6,10,14,14,40,Instinct
857,0,2,6,4,1,3,3,9,Mystic
858,8,6,26,8,7,13,13,35,Instinct
859,16,2,22,4,9,11,11,33,Instinct
860,20,0,22,2,10,11,11,34,Instinct
861,0,2,4,2,1,2,2,6,Valor
862,4,2,10,4,3,5,5,15,Mystic
863,0,2,6,2,1,3,3,8,Valor
864,0,0,2,2,0,1,1,4,Mystic
865,0,0,2,2,0,1,1,4,Mystic
866,4,0,6,2,2,3,3,10,Valor
867,12,8,32,8,10,16,16,43,Instinct
868,0,2,4,2,1,2,2,6,Valor
869,2,0,4,2,1,2,2,7,Valor
870,6,10,30,12,8,15,15,40,Instinct
871,0,0,2,2,0,1,1,4,Valor
872,12,6,30,8,9,15,15,41,Instinct
873,0,0,2,2,0,1,1,4,Mystic
874,0,0,2,2,0,1,1,4,Mystic
875,4,0,6,2,2,3,3,10,Mystic
876,10,6,28,8,8,14,14,38,Instinct
877,0,2,4,2,1,2,2,6,Mystic
878,0,2,6,2,1,3,3,8,Mystic
879,6,0,8,2,3,4,4,13,Mystic
880,12,8,32,10,10,16,16,44,Instinct
881,0,0,2,2,0,1,1,4,Mystic
882,2,0,4,2,1,2,2,7,Valor
883,0,2,6,4,1,3,3,9,Mystic
884,0,0,2,2,0,1,1,4,Valor
885,2,0,4,2,1,2,2,7,Valor
886,2,0,4,2,1,2,2,7,Mystic
887,6,0,8,2,3,4,4,13,Mystic
888,0,2,6,2,1,3,3,8,Mystic
889,10,4,20,6,7,10,10,29,Instinct
890,0,0,2,2,0,1,1,4,Mystic
891,0,0,2,2,0,1,1,4,Valor
892,0,0,2,2,0,1,1,4,Valor
893,4,0,6,2,2,3,3,10,Mystic
894,4,0,6,2,2,3,3,10,Mystic
895,2,0,4,2,1,2,2,7,Mystic
896,14,2,20,4,8,10,10,30,Instinct
897,16,2,22,4,9,11,11,33,Instinct
898,0,2,4,2,1,2,2,6,Valor
899,0,2,4,2,1,2,2,6,Valor
900,14,2,20,4,8,10,10,30,Instinct
901,16,2,22,4,9,11,11,33,Instinct
902,6,2,12,4,4,6,6,18,Mystic
903,0,0,2,2,0,1,1,4,Valor
904,4,2,8,2,3,4,4,12,Valor
905,0,0,2,2,0,1,1,4,Valor
906,14,4,24,6,9,12,12,35,Instinct
907,0,2,4,2,1,2,2,6,Valor
908,16,6,28,6,11,14,14,40,Instinct
909,2,0,4,2,1,2,2,7,Valor
910,2,2,8,4,2,4,4,12,Valor
911,14,6,28,6,10,14,14,39,Instinct
912,0,0,2,2,0,1,1,4,Valor
913,0,0,2,2,0,1,1,4,Valor
914,6,0,8,2,3,4,4,13,Valor
915,12,6,34,8,9,17,17,45,Instinct
916,2,0,4,2,1,2,2,7,Mystic
917,4,0,6,2,2,3,3,10,Valor
918,0,2,4,2,1,2,2,6,Mystic
919,0,0,2,2,0,1,1,4,Valor
920,14,2,22,4,8,11,11,32,Instinct
921,2,0,4,2,1,2,2,7,Valor
922,16,2,24,4,9,12,12,35,Instinct
923,4,0,6,2,2,3,3,10,Mystic
924,6,8,26,10,7,13,13,35,Instinct
925,4,0,6,2,2,3,3,10,Mystic
926,4,0,6,2,2,3,3,10,Valor
927,6,10,34,12,8,17,17,44,Instinct
928,2,4,14,6,3,7,7,19,Valor
929,2,0,4,2,1,2,2,7,Valor
930,12,4,22,6,8,11,11,32,Instinct
931,4,8,24,10,6,12,12,32,Instinct
932,14,0,16,2,7,8,8,25,Instinct
933,2,2,8,4,2,4,4,12,Valor
934,0,2,6,4,1,3,3,9,Valor
935,0,0,2,2,0,1,1,4,Mystic
936,12,2,20,4,7,10,10,29,Instinct
937,2,0,4,2,1,2,2,7,Mystic
938,14,6,28,8,10,14,14,40,Instinct
939,4,2,8,2,3,4,4,12,Valor
940,16,4,24,4,10,12,12,35,Instinct
941,4,10,30,12,7,15,15,39,Instinct
942,0,0,2,2,0,1,1,4,Mystic
943,0,2,4,2,1,2,2,6,Valor
944,0,0,2,2,0,1,1,4,Valor
945,18,0,20,2,9,10,10,31,Instinct
946,0,2,6,4,1,3,3,9,Mystic
947,0,0,2,2,0,1,1,4,Mystic
948,0,0,2,2,0,1,1,4,Mystic
949,0,0,2,2,0,1,1,4,Mystic
950,10,6,26,8,8,13,13,36,Instinct
951,0,0,2,2,0,1,1,4,Mystic
952,18,4,28,6,11,14,14,41,Instinct
953,0,2,6,4,1,3,3,9,Valor
954,16,2,22,4,9,11,11,33,Instinct
955,0,0,2,2,0,1,1,4,Mystic
956,12,6,26,6,9,13,13,36,Instinct
957,4,0,6,2,2,3,3,10,Valor
958,0,0,2,2,0,1,1,4,Mystic
959,0,0,2,2,0,1,1,4,Mystic
960,0,0,2,2,0,1,1,4,Valor
961,0,0,2,2,0,1,1,4,Valor
962,0,0,2,2,0,1,1,4,Valor
963,0,2,4,2,1,2,2,6,Mystic
964,0,2,6,4,1,3,3,9,Valor
965,16,2,22,4,9,11,11,33,Instinct
966,8,6,24,8,7,12,12,33,Instinct
967,0,0,2,2,0,1,1,4,Valor
968,0,0,2,2,0,1,1,4,Mystic
969,0,0,2,2,0,1,1,4,Mystic
970,0,0,2,2,0,1,1,4,Mystic
971,12,4,22,6,8,11,11,32,Instinct
972,2,2,6,2,2,3,3,9,Valor
973,6,2,10,2,4,5,5,15,Valor
974,4,0,6,2,2,3,3,10,Mystic
975,0,2,8,2,1,4,4,10,Valor
976,18,2,26,4,10,13,13,38,Instinct
977,2,2,8,4,2,4,4,12,Valor
978,0,0,2,2,0,1,1,4,Mystic
979,12,6,26,6,9,13,13,36,Valor
980,8,0,10,2,4,5,5,16,Mystic
981,8,0,10,2,4,5,5,16,Valor
982,4,0,6,2,2,3,3,10,Valor
983,6,8,26,10,7,13,13,35,Instinct
984,2,0,4,2,1,2,2,7,Valor
985,0,2,6,4,1,3,3,9,Valor
986,2,0,4,2,1,2,2,7,Mystic
987,0,0,2,2,0,1,1,4,Mystic
988,6,2,12,4,4,6,6,18,Mystic
989,10,4,26,6,7,13,13,35,Instinct
990,4,0,6,2,2,3,3,10,Valor
991,0,2,6,4,1,3,3,9,Mystic
992,0,2,4,2,1,2,2,6,Mystic
993,12,4,26,6,8,13,13,36,Instinct
994,6,0,8,2,3,4,4,13,Mystic
995,6,0,8,2,3,4,4,13,Valor
996,2,0,4,2,1,2,2,7,Valor
997,0,0,2,2,0,1,1,4,Mystic
998,2,2,8,2,2,4,4,11,Valor
999,14,4,24,6,9,12,12,35,Instinct
1000,16,2,20,2,9,10,10,30,Instinct
1001,12,0,14,2,6,7,7,22,Mystic
1002,2,0,4,2,1,2,2,7,Mystic
1003,0,2,6,4,1,3,3,9,Mystic
1004,14,4,30,6,9,15,15,41,Instinct
1005,2,2,6,2,2,3,3,9,Valor
1006,12,2,16,2,7,8,8,24,Mystic
1007,18,0,20,2,9,10,10,31,Instinct
1008,14,4,24,6,9,12,12,35,Instinct
1009,0,2,4,2,1,2,2,6,Mystic
1010,10,4,22,6,7,11,11,31,Instinct
1011,10,4,20,6,7,10,10,29,Instinct
1012,0,2,8,4,1,4,4,11,Mystic
1013,14,6,28,8,10,14,14,40,Instinct
1014,0,0,2,2,0,1,1,4,Mystic
1015,2,4,10,4,3,5,5,14,Mystic
1016,0,2,6,4,1,3,3,9,Valor
1017,16,4,26,6,10,13,13,38,Instinct
1018,0,2,4,2,1,2,2,6,Mystic
1019,2,0,4,2,1,2,2,7,Mystic
1020,0,0,2,2,0,1,1,4,Valor
1021,2,0,4,2,1,2,2,7,Valor
1022,2,0,4,2,1,2,2,7,Valor
1023,0,2,6,2,1,3,3,8,Valor
1024,12,4,24,6,8,12,12,34,Instinct
1025,14,6,28,6,10,14,14,39,Instinct
1026,8,10,34,12,9,17,17,45,Instinct
1027,0,0,2,2,0,1,1,4,Mystic
1028,0,0,2,2,0,1,1,4,Mystic
1029,2,0,4,2,1,2,2,7,Mystic
1030,10,6,24,8,8,12,12,34,Instinct
1031,16,6,28,6,11,14,14,40,Instinct
1032,0,0,2,2,0,1,1,4,Mystic
1033,0,0,2,2,0,1,1,4,Valor
1034,0,2,4,2,1,2,2,6,Mystic
1035,0,0,2,2,0,1,1,4,Valor
1036,2,2,6,2,2,3,3,9,Valor
1037,2,0,4,2,1,2,2,7,Valor
1038,18,0,20,2,9,10,10,31,Instinct
1039,0,0,2,2,0,1,1,4,Mystic
1040,0,0,2,2,0,1,1,4,Mystic
1041,12,4,22,6,8,11,11,32,Instinct
1042,0,0,2,2,0,1,1,4,Valor
1043,18,2,24,4,10,12,12,36,Instinct
1044,2,0,4,2,1,2,2,7,Valor
1045,2,0,4,2,1,2,2,7,Mystic
1046,2,0,4,2,1,2,2,7,Valor
1047,10,6,24,6,8,12,12,33,Instinct
1048,0,2,4,2,1,2,2,6,Valor
1049,14,2,22,4,8,11,11,32,Instinct
1050,14,2,20,4,8,10,10,30,Instinct
1051,8,6,26,8,7,13,13,35,Instinct
1052,6,2,10,2,4,5,5,15,Mystic
1053,4,0,6,2,2,3,3,10,Valor
1054,2,0,4,2,1,2,2,7,Mystic
1055,0,2,4,2,1,2,2,6,Valor
1056,12,4,24,6,8,12,12,34,Instinct
1057,0,2,6,4,1,3,3,9,Mystic
1058,2,0,4,2,1,2,2,7,Valor
1059,12,6,26,6,9,13,13,36,Instinct
1060,0,2,6,4,1,3,3,9,Mystic
1061,0,0,2,2,0,1,1,4,Mystic
1062,14,2,20,4,8,10,10,30,Instinct
1063,0,0,2,2,0,1,1,4,Mystic
1064,4,0,6,2,2,3,3,10,Valor
1065,2,0,4,2,1,2,2,7,Valor
1066,4,0,6,2,2,3,3,10,Mystic
1067,4,0,6,2,2,3,3,10,Valor
1068,10,0,12,2,5,6,6,19,Mystic
1069,14,4,26,6,9,13,13,37,Instinct
1070,0,0,2,2,0,1,1,4,Mystic
1071,10,6,26,8,8,13,13,36,Instinct
1072,4,2,10,4,3,5,5,15,Valor
1073,4,0,6,2,2,3,3,10,Mystic
1074,0,0,2,2,0,1,1,4,Mystic
1075,2,2,8,4,2,4,4,12,Valor
1076,0,0,2,2,0,1,1,4,Mystic
1077,2,2,8,4,2,4,4,12,Valor
1078,4,2,12,4,3,6,6,17,Valor
1079,0,2,6,4,1,3,3,9,Mystic
1080,16,4,24,4,10,12,12,35,Instinct
1081,2,0,4,2,1,2,2,7,Valor
1082,14,6,30,8,10,15,15,42,Instinct
1083,18,0,20,2,9,10,10,31,Instinct
1084,2,4,12,6,3,6,6,17,Valor
1085,4,0,6,2,2,3,3,10,Mystic
1086,2,0,4,2,1,2,2,7,Valor
1087,12,6,28,6,9,14,14,38,Instinct
1088,2,0,4,2,1,2,2,7,Valor
1089,16,2,24,4,9,12,12,35,Instinct
1090,0,0,2,2,0,1,1,4,Valor
1091,0,0,2,2,0,1,1,4,Mystic
1092,2,0,4,2,1,2,2,7,Valor
1093,4,0,6,2,2,3,3,10,Valor
1094,12,4,24,6,8,12,12,34,Instinct
1095,2,0,4,2,1,2,2,7,Mystic
1096,6,0,8,2,3,4,4,13,Mystic
1097,2,2,8,4,2,4,4,12,Valor
1098,0,0,2,2,0,1,1,4,Valor
1099,8,0,10,2,4,5,5,16,Mystic
1100,4,0,6,2,2,3,3,10,Valor
1101,0,0,2,2,0,1,1,4,Valor
1102,2,0,4,2,1,2,2,7,Mystic
1103,14,6,34,6,10,17,17,45,Instinct
1104,18,2,22,2,10,11,11,33,Instinct
1105,2,2,8,4,2,4,4,12,Mystic
1106,6,2,10,2,4,5,5,15,Valor
1107,12,0,14,2,6,7,7,22,Mystic
1108,0,0,2,2,0,1,1,4,Mystic
1109,12,8,40,10,10,20,20,52,Instinct
1110,6,2,12,4,4,6,6,18,Mystic
1111,12,8,28,8,10,14,14,39,Instinct
1112,4,2,10,2,3,5,5,14,Valor
1113,2,2,10,4,2,5,5,14,Valor
1114,12,0,14,2,6,7,7,22,Mystic
1115,2,0,4,2,1,2,2,7,Mystic
1116,0,2,6,4,1,3,3,9,Mystic
1117,0,0,2,2,0,1,1,4,Mystic
1118,6,0,8,2,3,4,4,13,Mystic
1119,16,6,28,6,11,14,14,40,Instinct
1120,12,0,14,2,6,7,7,22,Mystic
1121,0,0,2,2,0,1,1,4,Valor
1122,10,6,26,8,8,13,13,36,Instinct
1123,0,2,4,2,1,2,2,6,Valor
1124,0,2,6,4,1,3,3,9,Valor
1125,18,0,20,2,9,10,10,31,Instinct
1126,6,6,28,8,6,14,14,36,Instinct
1127,2,2,8,4,2,4,4,12,Valor
1128,0,0,2,2,0,1,1,4,Valor
1129,0,0,2,2,0,1,1,4,Mystic
1130,0,0,2,2,0,1,1,4,Valor
1131,14,4,32,6,9,16,16,43,Instinct
1132,0,0,2,2,0,1,1,4,Mystic
1133,0,0,2,2,0,1,1,4,Mystic
1134,6,0,8,2,3,4,4,13,Mystic
1135,0,2,4,2,1,2,2,6,Valor
1136,0,0,2,2,0,1,1,4,Valor
1137,16,2,22,4,9,11,11,33,Instinct
1138,0,2,4,2,1,2,2,6,Mystic
1139,0,2,4,2,1,2,2,6,Valor
1140,2,2,8,4,2,4,4,12,Mystic
1141,14,4,26,6,9,13,13,37,Instinct
1142,0,0,2,2,0,1,1,4,Valor
1143,4,0,6,2,2,3,3,10,Mystic
1144,14,6,28,6,10,14,14,39,Instinct
1145,10,4,22,6,7,11,11,31,Instinct
1146,2,0,4,2,1,2,2,7,Mystic
1147,2,2,8,4,2,4,4,12,Mystic
1148,0,2,8,4,1,4,4,11,Mystic
1149,0,0,2,2,0,1,1,4,Mystic
1150,14,4,26,6,9,13,13,37,Instinct
1151,18,0,20,2,9,10,10,31,Instinct
1152,6,8,36,10,7,18,18,45,Instinct
1153,6,2,12,4,4,6,6,18,Valor
1154,2,0,4,2,1,2,2,7,Valor
1155,4,8,28,10,6,14,14,36,Instinct
1156,4,2,10,4,3,5,5,15,Mystic
1157,0,0,2,2,0,1,1,4,Valor
1158,12,2,18,4,7,9,9,27,Instinct
1159,10,6,24,8,8,12,12,34,Instinct
1160,0,0,2,2,0,1,1,4,Mystic
1161,0,0,2,2,0,1,1,4,Mystic
1162,0,0,2,2,0,1,1,4,Mystic
1163,0,0,2,2,0,1,1,4,Mystic
1164,4,0,6,2,2,3,3,10,Valor
1165,0,2,6,4,1,3,3,9,Valor
1166,12,6,26,6,9,13,13,36,Instinct
1167,14,8,38,8,11,19,19,50,Instinct
1168,0,0,2,2,0,1,1,4,Valor
1169,4,0,6,2,2,3,3,10,Mystic
1170,10,0,12,2,5,6,6,19,Mystic
1171,2,0,4,2,1,2,2,7,Valor
1172,0,2,4,2,1,2,2,6,Valor
1173,14,2,24,4,8,12,12,34,Instinct
1174,4,2,8,2,3,4,4,12,Valor
1175,2,0,4,2,1,2,2,7,Mystic
1176,18,4,30,6,11,15,15,43,Instinct
1177,4,2,10,4,3,5,5,15,Mystic
1178,2,0,4,2,1,2,2,7,Mystic
1179,4,0,6,2,2,3,3,10,Valor
1180,0,0,2,2,0,1,1,4,Valor
1181,0,2,6,2,1,3,3,8,Mystic
1182,2,0,4,2,1,2,2,7,Mystic
1183,0,0,2,2,0,1,1,4,Mystic
1184,4,0,6,2,2,3,3,10,Mystic
1185,0,0,2,2,0,1,1,4,Valor
1186,16,4,28,6,10,14,14,40,Instinct
1187,0,0,2,2,0,1,1,4,Mystic
1188,0,2,6,4,1,3,3,9,Mystic
1189,4,4,14,4,4,7,7,19,Valor
1190,2,0,4,2,1,2,2,7,Valor
1191,12,4,26,6,8,13,13,36,Instinct
1192,6,8,30,10,7,15,15,39,Instinct
1193,12,6,26,8,9,13,13,37,Instinct
1194,10,2,16,4,6,8,8,24,Mystic
1195,12,4,22,6,8,11,11,32,Instinct
1196,6,0,8,2,3,4,4,13,Valor
1197,4,2,8,2,3,4,4,12,Valor
1198,0,2,6,4,1,3,3,9,Valor
1199,8,0,10,2,4,5,5,16,Mystic
